country,fiw_region,year,fiw_status,fiw_pr_rating,fiw_cl_rating,fiw_a,fiw_b,fiw_c,fiw_pr,fiw_d,fiw_e,fiw_f,fiw_g,fiw_cl,fiw_total
Abkhazia,Eurasia,2016,PF,4,5,6,8,5,19,8,6,4,5,23,42
Afghanistan,Asia,2016,NF,6,6,2,6,2,10,6,4,2,2,14,24
Albania,Europe,2016,PF,3,3,8,13,6,27,13,9,9,9,40,67
Algeria,MENA,2016,NF,6,5,4,4,3,11,7,5,5,7,24,35
Andorra,Europe,2016,F,1,1,12,15,12,39,16,11,15,15,57,96
Angola,SSA,2016,NF,6,6,3,6,1,10,5,3,3,3,14,24
Antigua and Barbuda,Americas,2016,F,2,2,12,13,8,33,14,9,13,13,49,82
Argentina,Americas,2016,F,2,2,11,14,6,31,14,11,10,13,48,79
Armenia,Eurasia,2016,PF,5,4,5,7,4,16,9,6,6,9,30,46
Australia,Asia,2016,F,1,1,12,16,12,40,16,12,15,15,58,98
Austria,Europe,2016,F,1,1,12,15,10,37,16,12,15,15,58,95
Azerbaijan,Eurasia,2016,NF,7,6,1,3,1,5,3,1,2,5,11,16
Bahamas,Americas,2016,F,1,1,12,16,10,38,16,12,13,13,54,92
Bahrain,MENA,2016,NF,7,6,2,2,3,4,2,1,1,6,10,14
Bangladesh,Asia,2016,PF,4,4,7,9,5,21,7,6,6,9,28,49
Barbados,Americas,2016,F,1,1,12,16,12,40,16,12,15,15,58,98
Belarus,Eurasia,2016,NF,7,6,0,3,1,4,3,1,2,7,13,17
Belgium,Europe,2016,F,1,1,12,16,12,40,15,12,14,15,56,96
Belize,Americas,2016,F,1,2,12,14,10,36,15,11,12,13,51,87
Benin,SSA,2016,F,2,2,9,16,8,33,15,12,12,10,49,82
Bhutan,Asia,2016,PF,3,4,10,10,10,29,9,4,6,8,27,56
Bolivia,Americas,2016,PF,3,3,11,11,7,29,14,9,6,10,39,68
Bosnia and Herzegovina,Europe,2016,PF,4,3,8,10,4,22,10,7,8,10,35,57
Botswana,SSA,2016,F,3,2,10,10,8,28,12,10,12,11,45,73
Brazil,Americas,2016,F,2,2,11,14,8,33,15,10,10,13,48,81
Brunei,Asia,2016,NF,6,5,0,3,3,7,6,3,6,7,22,29
Bulgaria,Europe,2016,F,2,2,11,14,8,33,14,11,10,12,47,80
Burkina Faso,SSA,2016,PF,4,3,6,9,6,21,14,8,8,8,38,59
Burundi,SSA,2016,NF,7,6,1,4,0,5,6,2,1,5,14,19
Cambodia,Asia,2016,NF,6,5,4,4,3,11,9,3,3,6,21,32
Cameroon,SSA,2016,NF,6,6,3,3,3,9,7,3,1,4,15,24
Canada,Americas,2016,F,1,1,12,16,12,40,16,12,15,16,59,99
Cape Verde,SSA,2016,F,1,1,12,15,10,37,15,11,14,13,53,90
Central African Republic,SSA,2016,NF,7,7,1,1,0,1,4,1,0,1,6,7
Chad,SSA,2016,NF,7,6,2,1,1,4,7,5,1,3,16,20
Chile,Americas,2016,F,1,1,12,15,11,38,16,12,14,15,57,95
China,Asia,2016,NF,7,6,0,1,2,1,4,3,2,6,15,16
Colombia,Americas,2016,PF,3,4,10,11,8,29,12,5,7,10,34,63
Comoros,SSA,2016,PF,3,4,9,11,4,24,10,7,8,6,31,55
Congo (Brazzaville),SSA,2016,NF,6,5,1,2,3,6,7,6,2,7,22,28
Congo (Kinshasa),SSA,2016,NF,6,6,3,4,2,9,8,3,0,5,16,25
Costa Rica,Americas,2016,F,1,1,12,15,10,37,16,11,13,13,53,90
Cote d'Ivoire,SSA,2016,PF,4,4,7,8,5,20,11,7,6,7,31,51
Crimea,Eurasia,2016,NF,7,6,0,0,0,-1,3,1,0,6,10,9
Croatia,Europe,2016,F,1,2,12,15,10,37,14,12,11,13,50,87
Cuba,Americas,2016,NF,7,6,0,0,1,1,5,0,3,6,14,15
Cyprus,Europe,2016,F,1,1,11,16,11,38,15,12,15,14,56,94
Czech Republic,Europe,2016,F,1,1,12,15,11,38,16,12,14,15,57,95
Denmark,Europe,2016,F,1,1,12,16,12,40,16,12,15,15,58,98
Djibouti,SSA,2016,NF,6,5,3,3,3,9,6,3,4,6,19,28
Dominica,Americas,2016,F,1,1,12,16,10,38,15,12,15,15,57,95
Dominican Republic,Americas,2016,PF,3,3,10,10,9,29,14,10,8,9,41,70
Ecuador,Americas,2016,PF,3,3,7,11,6,24,12,7,6,10,35,59
Egypt,MENA,2016,NF,6,5,3,4,2,9,5,4,2,7,18,27
El Salvador,Americas,2016,F,2,3,10,14,9,33,12,8,8,8,36,69
Equatorial Guinea,SSA,2016,NF,7,7,0,1,0,1,4,0,0,3,7,8
Eritrea,SSA,2016,NF,7,7,0,0,1,1,0,0,0,2,2,3
Estonia,Europe,2016,F,1,1,12,15,11,38,16,12,14,14,56,94
Ethiopia,SSA,2016,NF,7,6,1,0,3,4,3,0,3,5,11,15
Fiji,Asia,2016,PF,3,3,9,11,7,27,11,5,9,10,35,62
Finland,Europe,2016,F,1,1,12,16,12,40,16,12,16,16,60,100
France,Europe,2016,F,1,1,12,15,11,38,14,11,13,15,53,91
Gabon,SSA,2016,NF,6,5,2,4,3,9,10,4,6,5,25,34
Gaza Strip,MENA,2016,NF,7,6,0,2,1,3,4,3,0,2,9,12
Georgia,Eurasia,2016,PF,3,3,9,11,7,27,11,8,8,10,37,64
Germany,Europe,2016,F,1,1,12,15,12,39,15,12,14,15,56,95
Ghana,SSA,2016,F,1,2,12,15,10,37,14,11,11,10,46,83
Greece,Europe,2016,F,2,2,12,15,8,35,14,11,10,13,48,83
Grenada,Americas,2016,F,1,2,12,16,10,38,15,11,12,13,51,89
Guatemala,Americas,2016,PF,4,4,8,10,5,23,12,6,5,8,31,54
Guinea,SSA,2016,PF,5,5,6,8,3,17,9,5,4,5,23,40
Guinea-Bissau,SSA,2016,PF,5,5,7,8,1,16,10,5,3,5,23,39
Guyana,Americas,2016,F,2,3,11,13,8,32,15,10,8,9,42,74
Haiti,Americas,2016,PF,5,5,4,8,5,17,10,4,4,6,24,41
Honduras,Americas,2016,PF,4,4,7,9,3,19,9,5,4,8,26,45
Hong Kong,Asia,2016,PF,5,2,3,7,6,16,12,8,14,13,47,63
Hungary,Europe,2016,F,2,2,9,15,8,32,13,11,10,13,47,79
Iceland,Europe,2016,F,1,1,12,16,12,40,16,12,16,16,60,100
India,Asia,2016,F,2,3,12,14,9,35,13,10,9,10,42,77
Indian Kashmir,Asia,2016,PF,4,4,9,9,4,22,9,6,6,8,29,51
Indonesia,Asia,2016,PF,2,4,11,14,6,31,12,8,5,9,34,65
Iran,MENA,2016,NF,6,6,3,2,2,7,2,1,3,4,10,17
Iraq,MENA,2016,NF,5,6,8,5,2,12,5,6,0,4,15,27
Ireland,Europe,2016,F,1,1,12,16,11,39,16,12,14,15,57,96
Israel,MENA,2016,F,1,2,12,14,10,36,12,10,11,11,44,80
Italy,Europe,2016,F,1,1,12,14,10,36,15,12,12,14,53,89
Jamaica,Americas,2016,F,2,3,12,13,9,34,15,9,7,10,41,75
Japan,Asia,2016,F,1,1,12,16,12,40,15,12,15,14,56,96
Jordan,MENA,2016,NF,6,5,2,6,3,11,7,4,6,8,25,36
Kazakhstan,Eurasia,2016,NF,6,5,2,3,1,6,4,2,4,8,18,24
Kenya,SSA,2016,PF,4,4,7,10,5,22,11,6,5,7,29,51
Kiribati,Asia,2016,F,1,1,12,16,8,36,15,12,15,13,55,91
Kosovo,Europe,2016,PF,3,4,9,10,5,24,9,6,6,7,28,52
Kuwait,MENA,2016,PF,5,5,2,7,4,13,6,4,7,6,23,36
Kyrgyzstan,Eurasia,2016,PF,5,5,6,6,4,14,9,4,4,7,24,38
Laos,Asia,2016,NF,7,6,0,0,1,1,4,0,2,5,11,12
Latvia,Europe,2016,F,2,2,12,14,9,35,15,12,12,12,51,86
Lebanon,MENA,2016,PF,5,4,2,9,2,13,11,7,5,7,30,43
Lesotho,SSA,2016,PF,3,3,10,12,6,28,14,7,9,9,39,67
Liberia,SSA,2016,PF,3,4,9,12,7,28,10,8,7,8,33,61
Libya,MENA,2016,NF,6,6,4,2,0,6,6,3,1,4,14,20
Liechtenstein,Europe,2016,F,1,1,12,15,12,39,16,12,15,16,59,98
Lithuania,Europe,2016,F,1,1,12,16,10,38,16,11,13,13,53,91
Luxembourg,Europe,2016,F,1,1,12,16,10,38,16,12,16,16,60,98
Macedonia,Europe,2016,PF,4,3,6,10,6,22,10,8,7,10,35,57
Madagascar,SSA,2016,PF,3,4,9,10,5,24,10,8,6,8,32,56
Malawi,SSA,2016,PF,3,3,8,12,7,27,13,8,9,7,37,64
Malaysia,Asia,2016,PF,4,4,6,7,5,18,7,6,5,9,27,45
Maldives,Asia,2016,PF,4,5,7,6,6,19,6,5,6,7,24,43
Mali,SSA,2016,PF,5,4,6,7,4,17,12,6,6,4,28,45
Malta,Europe,2016,F,1,1,12,16,11,39,16,12,15,14,57,96
Marshall Islands,Asia,2016,F,1,1,12,15,10,37,16,11,15,13,55,92
Mauritania,SSA,2016,NF,6,5,3,2,4,9,9,4,4,4,21,30
Mauritius,SSA,2016,F,1,2,12,15,11,38,15,12,13,12,52,90
Mexico,Americas,2016,PF,3,3,9,12,7,28,13,8,6,10,37,65
Micronesia,Asia,2016,F,1,1,12,15,10,37,16,11,15,14,56,93
Moldova,Eurasia,2016,PF,3,3,10,11,4,25,11,8,7,9,35,60
Monaco,Europe,2016,F,2,1,10,11,10,31,16,12,15,14,57,88
Mongolia,Asia,2016,F,1,2,11,16,9,36,15,11,12,12,50,86
Montenegro,Europe,2016,PF,3,3,9,11,7,27,12,9,10,12,43,70
Morocco,MENA,2016,PF,5,4,5,7,3,15,8,5,6,7,26,41
Mozambique,SSA,2016,PF,4,4,6,10,6,22,11,7,7,9,34,56
Myanmar,Asia,2016,NF,6,5,3,8,3,11,7,4,1,5,17,28
Nagorno-Karabakh,Eurasia,2016,PF,5,5,6,6,3,15,6,3,4,5,18,33
Namibia,SSA,2016,F,2,2,10,11,9,30,14,12,11,10,47,77
Nauru,Asia,2016,F,2,2,12,15,8,35,13,10,12,14,49,84
Nepal,Asia,2016,PF,3,4,9,11,5,25,9,5,5,7,26,51
Netherlands,Europe,2016,F,1,1,12,16,12,40,16,12,15,16,59,99
New Zealand,Asia,2016,F,1,1,12,16,12,40,16,12,15,15,58,98
Nicaragua,Americas,2016,PF,4,3,6,7,6,19,12,6,7,10,35,54
Niger,SSA,2016,PF,3,4,8,9,7,24,11,6,5,6,28,52
Nigeria,SSA,2016,PF,4,5,9,10,5,23,9,7,4,5,25,48
North Korea,Asia,2016,NF,7,7,0,0,0,0,0,0,0,3,3,3
Northern Cyprus,Europe,2016,F,2,2,11,12,9,32,14,9,12,12,47,79
Norway,Europe,2016,F,1,1,12,16,12,40,16,12,16,16,60,100
Oman,MENA,2016,NF,6,5,2,2,2,8,5,3,4,5,17,25
Pakistan,Asia,2016,PF,4,5,7,8,5,20,5,6,4,6,21,41
Pakistani Kashmir,Asia,2016,NF,6,5,4,4,3,9,6,4,3,6,19,28
Palau,Asia,2016,F,1,1,12,15,10,37,16,11,15,13,55,92
Panama,Americas,2016,F,2,2,12,15,8,35,15,11,10,12,48,83
Papua New Guinea,Asia,2016,PF,4,3,9,10,4,23,12,9,7,8,36,59
Paraguay,Americas,2016,PF,3,3,10,12,5,27,12,8,7,10,37,64
Peru,Americas,2016,F,2,3,10,13,7,30,15,8,8,10,41,71
Philippines,Asia,2016,PF,3,3,9,11,7,27,14,9,5,10,38,65
Poland,Europe,2016,F,1,1,12,16,10,38,16,12,13,14,55,93
Portugal,Europe,2016,F,1,1,12,16,11,39,16,12,15,15,58,97
Puerto Rico,Americas,2016,F,1,1,12,15,10,37,16,11,12,14,53,90
Qatar,MENA,2016,NF,6,5,2,2,3,9,8,2,4,4,18,27
Romania,Europe,2016,F,2,2,11,14,9,34,14,11,12,12,49,83
Russia,Eurasia,2016,NF,6,6,1,3,3,7,3,3,2,7,15,22
Rwanda,SSA,2016,NF,6,6,2,1,5,8,4,2,3,7,16,24
Samoa,Asia,2016,F,2,2,9,13,9,31,14,10,13,12,49,80
San Marino,Europe,2016,F,1,1,12,16,12,40,16,12,16,16,60,100
Sao Tome and Principe,SSA,2016,F,2,2,11,14,9,34,15,10,12,10,47,81
Saudi Arabia,MENA,2016,NF,7,7,0,0,1,3,3,0,2,2,7,10
Senegal,SSA,2016,F,2,2,11,13,9,33,15,10,10,10,45,78
Serbia,Europe,2016,F,2,2,10,13,7,30,14,11,10,13,48,78
Seychelles,SSA,2016,PF,3,3,9,10,7,26,11,9,11,11,42,68
Sierra Leone,SSA,2016,PF,3,3,10,11,7,28,12,7,9,9,37,65
Singapore,Asia,2016,PF,4,4,4,8,7,19,9,4,7,12,32,51
Slovenia,Europe,2016,F,1,1,12,16,11,39,14,12,14,13,53,92
Solomon Islands,Asia,2016,PF,3,3,9,10,6,25,14,9,8,12,43,68
Somalia,SSA,2016,NF,7,7,0,0,0,0,1,0,0,1,2,2
Somaliland,SSA,2016,PF,5,5,2,9,4,15,7,5,7,6,25,40
South Africa,SSA,2016,F,2,2,12,13,8,33,15,12,9,10,46,79
South Korea,Asia,2016,F,2,2,11,13,10,34,12,11,13,13,49,83
South Ossetia,Eurasia,2016,NF,7,6,2,2,0,2,4,1,1,3,9,11
South Sudan,SSA,2016,NF,7,6,3,1,1,2,4,3,1,4,12,14
Spain,Europe,2016,F,1,1,12,16,11,39,15,11,15,15,56,95
Sri Lanka,Asia,2016,PF,4,4,8,10,6,23,9,8,7,8,32,55
St. Kitts and Nevis,Americas,2016,F,2,1,10,16,9,35,15,12,13,13,53,88
St. Lucia,Americas,2016,F,1,1,12,16,11,39,15,12,12,14,53,92
St. Vincent and the Grenadines,Americas,2016,F,1,1,11,16,10,37,15,12,13,14,54,91
Sudan,SSA,2016,NF,7,7,2,3,1,2,2,1,0,1,4,6
Suriname,Americas,2016,F,2,3,12,14,8,34,15,11,7,10,43,77
Swaziland,SSA,2016,NF,7,5,0,1,0,1,7,2,4,4,17,18
Sweden,Europe,2016,F,1,1,12,16,12,40,16,12,16,16,60,100
Switzerland,Europe,2016,F,1,1,12,15,12,39,15,12,15,15,57,96
Syria,MENA,2016,NF,7,7,0,0,0,-3,2,0,0,0,2,-1
Taiwan,Asia,2016,F,1,2,12,15,10,37,14,11,14,13,52,89
Tajikistan,Eurasia,2016,NF,7,6,1,0,1,2,4,3,3,4,14,16
Tanzania,SSA,2016,PF,3,4,8,12,7,27,9,6,9,9,33,60
Thailand,Asia,2016,NF,6,5,1,3,3,7,6,4,5,10,25,32
The Gambia,SSA,2016,NF,7,6,1,4,0,5,3,3,1,6,13,18
Tibet,Asia,2016,NF,7,7,0,0,1,-2,0,0,0,3,3,1
Timor-Leste,Asia,2016,PF,3,3,11,12,6,29,12,8,7,9,36,65
Togo,SSA,2016,PF,4,4,6,7,5,18,9,7,7,7,30,48
Tonga,Asia,2016,F,2,2,11,14,6,31,13,8,11,12,44,75
Transnistria,Eurasia,2016,NF,6,6,3,5,2,10,5,2,2,5,14,24
Trinidad and Tobago,Americas,2016,F,2,2,11,13,9,33,15,11,9,13,48,81
Tunisia,MENA,2016,F,1,3,12,16,9,37,13,9,9,11,42,79
Turkey,Europe,2016,PF,3,4,9,9,6,24,8,6,6,9,29,53
Turkmenistan,Eurasia,2016,NF,7,7,0,0,0,0,1,0,0,3,4,4
Tuvalu,Asia,2016,F,1,1,12,15,10,37,16,12,15,14,57,94
Uganda,SSA,2016,NF,6,5,3,5,3,11,9,4,5,7,25,36
Ukraine,Eurasia,2016,PF,3,3,9,10,6,25,11,9,6,10,36,61
United Arab Emirates,MENA,2016,NF,6,6,1,2,2,7,4,2,3,4,13,20
United Kingdom,Europe,2016,F,1,1,12,16,12,40,13,12,15,15,55,95
United States,Americas,2016,F,1,1,11,15,10,36,15,11,13,15,54,90
Uruguay,Americas,2016,F,1,1,12,16,12,40,16,12,15,15,58,98
Uzbekistan,Eurasia,2016,NF,7,7,0,0,0,0,0,0,0,3,3,3
Vanuatu,Asia,2016,F,2,2,9,15,7,31,15,11,10,11,47,78
Venezuela,Americas,2016,PF,5,5,5,8,2,15,8,3,1,8,20,35
Vietnam,Asia,2016,NF,7,5,0,1,2,3,4,1,4,8,17,20
West Bank,MENA,2016,NF,6,5,2,5,2,6,9,5,5,5,24,30
Western Sahara,MENA,2016,NF,7,7,0,0,0,-3,3,0,0,4,7,4
Yemen,MENA,2016,NF,7,6,2,1,1,4,5,3,2,3,13,17
Zambia,SSA,2016,PF,3,4,8,11,7,26,11,7,8,8,34,60
Zimbabwe,SSA,2016,PF,5,5,3,6,3,12,8,4,3,5,20,32
